1111111111
11000000E1
1P00000001
1100000CE1
1111111111