1111111111111
1000000000001
1000000000EP1
1111111111111