111111111111
100000000000
100000CEP001
111111111111