11111111111
10000000P01
100C0000001
11111111111