1111111111
1100000001
1P10000001
1100000CE1
1111111111