1111111111
1100000001
1PE0000001
1100000C11
1111111111