11111111111
10000000001
10C0000E001
11111111111