11111111111
1000000001
1P0000C0001
1000E000001
11111111111