11111111111111
1CCCCCCCCECCC1
1CCCCCCCCCCCC1
1CCCCCCCCCCCC1
1P0001101CCC11
11111111111111