11111111111111
10000000000001
1PC101E01CCCC1
11CCCCC11CCCC1
11111111111111