11111111111111
1CCCCC1CC0CCC1
11C1C0E0CCCC11
11CPCC111CCCC1
11111111111111