111111111111111111111
100000000000000000001
1P0000000000000000001
1000000C0000000000001
1E0000000000000000001
111111111111111111111