111111111111111111111
100000000000000000001
1P0000000000000000001
111100011100000000001
1E00000C0000000000001
111111111111111111111